15 10 4
##########
#        #
# #### # #
# #    # #
# # ## # #
# # ## # #
# # ## # #
# # #### #
# #      #
# #V## ###
# # #    #
# #    # #
# ## ### #
#        #
##########